+-+-+-+-+-+-+
|S      |   | 
+ +-+-+ +-+ +
|     |     |
+ +-+ +  +--+
|     |     |
+-+   + + + +
| |     | | |
+ +-+ +-+ +-+	
|   | |     |
+-+ + + +-+-+
|
+-+-+-+-+-+-+